0 0 0 0 0 0 0 0 0 0 0 0 0 0 0 0
0 0 0 0 0 0 0 0 0 0 0 0 0 0 0 0
0 0 0 0 0 0 0 0 0 0 0 0 0 0 0 0
0 0 0 0 0 0 0 0 0 0 0 0 0 0 0 0
0 0 0 0 0 0 0 0 0 0 0 0 0 0 0 0
0 0 0 0 0 0 0 0 0 0 0 0 0 0 0 0
0 0 0 0 0 0 0 0 0 0 0 0 0 0 0 0
0 0 0 0 0 0 0 0 0 0 0 0 0 0 0 0
0 9 8 8 8 8 8 8 8 8 8 8 8 8 8 8
0 10 6 5 5 5 5 5 5 5 5 5 5 5 5 7
0 10 3 2 2 2 2 2 2 2 2 2 2 2 2 4
0 10 3 2 2 2 2 2 2 2 2 2 2 2 2 4